

NO ./textures/wall_1.xpm
SO ./textures/wall_1.xpm
WE ./textures/wall_2.xpm
EA ./textures/wall_2.xpm

C  0, 0,0
F      20 , 20, 20


    1111111111111111111111111
    1000000000110001111000001
    1011000001110001  1111101
    1001000010000001111111101
111111111011N0000111000000001
10000000001100000111111001001
11110111111111000000000000001
11110111111111011101010000011
11000000110101011100000111001
10000000000000001100001101001
10000000000000001101010000001
10000001110101011111011100001
11110111111101011101111000001
11111111111111111111111111111




