NO ./textures/bluestone.xpm
SO ./textures/greystone.xpm
WE ./textures/redbrick.xpm
EA ./textures/purplestone.xpm

C  0, 0,212
F      1 , 1, 1


    1111111111111111111111111
    1000000000110001111000001
    1011000001110001  1111101
    1001000000000001111111101
11111111101100000111000000001
10000000001100000111111001001
11110111111111000000000000001
11110111111111011101010000011
11000000110101011100000111001
10000000000000001100001101001
10000000000000001101010000001    1111111
1000000111010101111101110N0011  11100111
11110111111101011101111000001   11111111
11111111111111111111111111111
