







NO ./textures/bluestone.xpm








SO ./textures/greystone.xpm
                        WE ./textures/redbrick.xpm
        EA ./textures/purplestone.xpm

        F 20,20,20
C 200,200,    200




11111
11101
10S01
10001
10001
10001
11001
10001
10001
10001
10001
10001
11111
