

NO ./textures/bluestone.xpm
SO ./textures/greystone.xpm
WE ./textures/redbrick.xpm
EA ./textures/purplestone.xpm

C 0,0,0
F 0,0,0

111111111111111111111
101011111000000111101
101010101011111110001
100010100010000010001
111110101111101011101
100000101000101000001
101111101011101111111
101000001010100000101
001011111010111110101
101010001010100010101
101110101010101010101
100000101010001010001
111111101011111011101
100000101000100010001
101110101110101110111
101000100000100010101
100011111111111011111
10S010000000000010001
100010111011111111111
101000001000000000001
111111111111111111111
