NO ./textures/bluestone.xpm
SO ./textures/greystone.xpm

                   WE ./textures/redbrick.xpm
C  0, 0,212
EA ./textures/purplestone.xpm


F      1 , 1, 1

                             111111111111111111111111
                             100000000000000000000001
                             100000000000000000000001
11111111111111111111111111111100000000000000000000001
10000000000000000000000000000000000000000000000000001
10000000000000000000000111111111111111111111111111111
100000000000000000000001
100000000000000000000001
100000111110000101010001
100000100010000000000001
100000100010000100010001
100000100010000000000001
100000111100001010100001
100000000000000000000001
100001111111111000000001
10001          100000001
100001111111111100000001
100000000000000000000001
10000000000000E000000001
100000000000000000000001
111111111000000000000001
100100001000000000000001
100000101000000000000001
100100001000000000000001
100111111000000000000001
100000000000000000000001
100000000000000000000001
111111111111111111111111
